{
  "id": "huluguan",
  "name": "호로관",
  "width": 32,
  "height": 48,
  "tileLegend": {
    ".": "plain",
    "g": "grass",
    "b": "bridge",
    "w": "waste",
    "v": "village",
    "B": "barracks",
    "d": "depot",
    "f": "forest",
    "m": "mountain",
    "F": "fort",
    "G": "gate",
    "r": "river",
    "#": "wall",
    "c": "cliff"
  },
  "tiles": [
    "...mmm....................mmm...",
    "...mmm....................mmm...",
    "...mmm....................mmm...",
    "...mmm.......FFFFFF.......mmm...",
    "...mmm.......FFFFFF.......mmm...",
    "...mmm....................mmm...",
    "...mmm....................mmm...",
    "...mmm....................mmm...",
    "...mmm..######GGGG######..mmm...",
    "........##............##........",
    "fff..........................fff",
    "fff...............BB.........fff",
    "fff.........vv...............fff",
    "fff...ffff...................fff",
    "fff...fff....................fff",
    "................................",
    "......................ffff......",
    ".......................fff......",
    "................................",
    "................................",
    "....ggg.........................",
    "....gggg........................",
    "........................gggg....",
    ".........................ggg....",
    "................................",
    "................................",
    "................................",
    "................................",
    "................................",
    "................................",
    "rrrrrrrrrrrrrrbbrrrrrrrrrrrrrrrr",
    "rrrrrrrrrrrrrrbbrrrrrrrrrrrrrrrr",
    "rrrrrrrrrrrrrrbbrrrrrrrrrrrrrrrr",
    "................................",
    "................................",
    "........gggg....................",
    "........ggg.....................",
    "....d...........................",
    "................................",
    "....................fffff.......",
    ".....................ffff.......",
    "................................",
    "................................",
    "fff..........................fff",
    "fff..........................fff",
    "fff..........................fff",
    "fff..........................fff",
    "................................"
  ]
}
