{
  "id": "xiaopei",
  "name": "소패",
  "width": 48,
  "height": 40,
  "tileLegend": {
    ".": "plain",
    "g": "grass",
    "b": "bridge",
    "f": "forest",
    "m": "mountain",
    "r": "river",
    "#": "wall",
    "G": "gate",
    "B": "barracks",
    "v": "village",
    "d": "depot"
  },
  "tiles": [
    "mmm..........................................mmm",
    "mmm..........................................mmm",
    "mmm...fff...............................ff...mmm",
    "mmm...ff...............................ff....mmm",
    "mmm..........................................mmm",
    "mmm.......ff.......................ff........mmm",
    "mmm..........................................mmm",
    "mmm...........ff.................ff..........mmm",
    "mmm..........................................mmm",
    "mmm..........................................mmm",
    "mmm..........................................mmm",
    "mmm..........................................mmm",
    "mmm..........................................mmm",
    "mmm..........................................mmm",
    "mmm..........................................mmm",
    "mmm..........................................mmm",
    "mmm..........................................mmm",
    "mmm..........................................mmm",
    "mmmrrrrrrrrrbrrrrrrrrrrrrrrrrrrrrrbrrrrrrrrrrmmm",
    "mmmrrrrrrrrrbrrrrrrrrrrrrrrrrrrrrrbrrrrrrrrrrmmm",
    "mmm..........................................mmm",
    "mmm...........f..................f...........mmm",
    "mmm.....gggggggggggggggggggggggggggggggg.....mmm",
    "mmm.....gggggggggggggggggggggggggggggggg.....mmm",
    "mmm.......ff.........................ff......mmm",
    "mmm..........................................mmm",
    "mmm.............#######GG#######.............mmm",
    "mmm.............#..............#.............mmm",
    "mmm.............#..............#.............mmm",
    "mmm.............#..............#.............mmm",
    "mmm.............#...BB.....v...#.............mmm",
    "mmm.............#...BB.....v...#.............mmm",
    "mmm.............#.......d......#.............mmm",
    "mmm.............#..............#.............mmm",
    "................#..............#................",
    "................#..............#................",
    "................#######GG#######................",
    "................................................",
    "................................................",
    "................................................"
  ]
}
