{
  "id": "xiapi1",
  "name": "하비 외곽 (1차)",
  "width": 48,
  "height": 32,
  "tileLegend": {
    ".": "plain",
    "g": "grass",
    "b": "bridge",
    "w": "waste",
    "v": "village",
    "B": "barracks",
    "d": "depot",
    "f": "forest",
    "m": "mountain",
    "F": "fort",
    "G": "gate",
    "r": "river",
    "#": "wall",
    "c": "cliff"
  },
  "tiles": [
    "ggg...ff...........................#############",
    ".......f...........................#...........#",
    ".......f...........................#..vv...vv..#",
    ".......f...........................G..vv...vv..#",
    "..........g........................G...........#",
    "..........gg.......................G..vv...FF..#",
    "....gg.............................#..vv...F...#",
    "...gggg............................#...........#",
    "...................................#..BB...vv..#",
    ".............f.....................#..BB...vv..#",
    "....g........ff....................#...........#",
    "...ggg......ff.............ff......#############",
    "....................f......f...................F",
    "............ff......ff.....f....................",
    "...............................................F",
    "......................................gg........",
    "..................gg...........................F",
    "............f.....ggg...........................",
    "............f.....gg...............ff...........",
    "...................................ff..........F",
    "....gg..........................................",
    "...ggg......ff.................................F",
    "............ff..................................",
    ".....................................gg.........",
    "rrrrrrrrrrrrrrrrrbbbrrrrrrrrrrrrrrrrrrrrrrrrrrrr",
    "rrrrrrrrrrrrrrrrrbbbrrrrrrrrrrrrrrrrrrrrrrrrrrrr",
    "ddd..............bbb...........................F",
    "dd...............bbb............................",
    "d....ff..........bbb..........ff......ff........",
    ".....ff..........bbb..........ff......ff........",
    "...................................mmmm.........",
    "..................................mmmmmmm......."
  ]
}
