{
  "id": "yingchuan",
  "name": "영천",
  "width": 48,
  "height": 32,
  "tileLegend": {
    ".": "plain",
    "g": "grass",
    "b": "bridge",
    "v": "village",
    "B": "barracks",
    "d": "depot",
    "f": "forest",
    "m": "mountain",
    "r": "river"
  },
  "tiles": [
    "mmmmm.......................................mmmm",
    "mmmm........................................mmmm",
    "mmm.........................................mmmm",
    "mm..............................................",
    "m........ff.....................................",
    ".........f......................................",
    "........fff.............................fff.....",
    "........ff..............................ffff....",
    ".......fff..............................fff.....",
    "................................................",
    "................................................",
    "................................................",
    ".........................................BdB....",
    ".........................................BBvBB..",
    ".........................................BvvvB..",
    ".....rrrrrrrrrrrrrrrbbbrrrrrrrrrrrrrrrrr.BBvBB..",
    ".....rrrrrrrrrrrrrrrbbbrrrrrrrrrrrrrrrrr.BdB....",
    "................................................",
    ".......................................ff.......",
    ".......................................ff.......",
    ".......................................ff.......",
    "................................................",
    "................................................",
    "................................................",
    "......................................ff........",
    "......................................ff........",
    "......................................f.........",
    "................................................",
    ".....................................ff.........",
    "mm..................................ff....mmm...",
    "mmm.......................................mmmm..",
    "mmmm......................................mmmmm."
  ]
}