{
  "id": "yingchuan",
  "name": "영천",
  "width": 48,
  "height": 32,
  "tileLegend": {
    ".": "plain",
    "g": "grass",
    "b": "bridge",
    "v": "village",
    "B": "barracks",
    "d": "depot",
    "f": "forest",
    "m": "mountain",
    "r": "river"
  },
  "tiles": [
    "mmmmm.......................................mmmm",
    "mmmm........................................mmmm",
    "mmm.........................................mmmm",
    "mm..............................................",
    "m........ff.....................................",
    ".........f......................................",
    "........fff.............................fff.....",
    "........ff..............................ffff....",
    ".......fff..............................fff.....",
    "................................................",
    "................................................",
    "................................................",
    ".........................................BdB....",
    ".........................................BBvBB..",
    ".........................................BvvvB..",
    "..............rrrrrrrrbrrrrrrrrrrr.......BBvBB..",
    ".....................rbr.................BdB....",
    ".....................rbr........................",
    ".....................rbr...............ff.......",
    ".....................rbr...............ff.......",
    ".....................rbr...............ff.......",
    ".....................rbr........................",
    ".....................rbr........................",
    ".....................rbr........................",
    ".....................rbr..............ff........",
    ".....................rbr..............ff........",
    ".....................rbr..............f.........",
    ".....................rbr........................",
    ".....................rbr.............ff.........",
    "mm...................rbr............ff....mmm...",
    "mmm..................rbr..................mmmm..",
    "mmmm.................rbr..................mmmmm."
  ]
}
